111111111111111111111
1e00000000100000000e1
101011111010111110101
101000000010000000101
101111111111111111101
100000000000000000001
111111111101111111111
1000000000p0000000001
101111111010111111101
100000011010110000001
101011111010111110101
101000000010000000101
101110111010111011101
1000000000000000000e1
111111111111111111111