1111111111111111111111111
1000000000000000000000001
1011111110101010111111101
100000000d10e01*000000001
11111111111t1t11111111111
1000000000001000000000001
1011111111101011111111101
1000000000001000000000001
1011111011101011101111101
1011111011101011101111101
1011111011101011101111101
1e000000000000000000000p1
111111111111t111111111111
111111111111t111111111111
1000000000000000000000001
1011111110101010111111101
100000000d10e01*000000001
11111111111t1t11111111111
1000000000001000000000001
1011111111101011111111101
1000000000001000000000001
1011111011101011101010101
1011111011101011100000001
1011111011101011101010101
1e00000000000000000000001
1111111111111111111111111