111111111111111111111
1e0000000000000000001
101111111010111111101
101111*00010000111101
101111011010110111101
100000000000000000001
111111111t1t111111111
100000000000000000001
101111011010110111101
101111000010000111101
101111111010111111101
1e00000000000000000p1
111111111111111111111